# fast-change-dir: use relative keyword
alias ll="ls -la"

#
# GroupName
#
# select or switch GroupName
alias ga="source /bin/gisanfu-groupname.sh select"
# append GroupName
alias gaa="/bin/gisanfu-groupname.sh append"
# edit GroupName 
alias gaaa="/bin/gisanfu-groupname.sh edit"

#
# cd
#
alias d=". /bin/gisanfu-cddir.sh"
# cd point
alias dv=". /bin/gisanfu-dirpoint.sh"
# append point
alias dvv=". /bin/gisanfu-dirpoint-append.sh"
# edit point
alias dvvv=". /bin/gisanfu-dirpoint-edit.sh"

# vim
alias v=". /bin/gisanfu-editfile.sh"
alias vf=". /bin/gisanfu-vimlist-append.sh"
alias vff="/bin/gisanfu-vimlist.sh"
alias vfff=". /bin/gisanfu-vimlist-edit.sh"
alias vfe=". /bin/gisanfu-pos-vimlist-append.sh 1"
alias vfee=". /bin/gisanfu-pos-vimlist-append.sh 2"
alias vfeee=". /bin/gisanfu-pos-vimlist-append.sh 3"
alias vfeeee=". /bin/gisanfu-pos-vimlist-append.sh 4"
alias vfeeeee=". /bin/gisanfu-pos-vimlist-append.sh 5"
alias vfeeeeee=". /bin/gisanfu-pos-vimlist-append.sh 6"

#
# back, and cd dir
#
alias g=". /bin/gisanfu-backdir.sh"
# back back... layer dir
alias ge=". /bin/gisanfu-back-backdir.sh 1"
alias gee=". /bin/gisanfu-back-backdir.sh 2"
alias geee=". /bin/gisanfu-back-backdir.sh 3"
alias geeee=". /bin/gisanfu-back-backdir.sh 4"
alias geeeee=". /bin/gisanfu-back-backdir.sh 5"
alias geeeeee=". /bin/gisanfu-back-backdir.sh 6"
# back and cd dir, use position
alias gde=". /bin/gisanfu-pos-backdir.sh 1"
alias gdee=". /bin/gisanfu-pos-backdir.sh 2"
alias gdeee=". /bin/gisanfu-pos-backdir.sh 3"
alias gdeeee=". /bin/gisanfu-pos-backdir.sh 4"
alias gdeeeee=". /bin/gisanfu-pos-backdir.sh 5"
alias gdeeeeee=". /bin/gisanfu-pos-backdir.sh 6"

# fast-change-dir: cd dir, use position
alias de=". /bin/gisanfu-pos-cddir.sh 1"
alias dee=". /bin/gisanfu-pos-cddir.sh 2"
alias deee=". /bin/gisanfu-pos-cddir.sh 3"
alias deeee=". /bin/gisanfu-pos-cddir.sh 4"
alias deeeee=". /bin/gisanfu-pos-cddir.sh 5"
alias deeeeee=". /bin/gisanfu-pos-cddir.sh 6"

# fast-change-dir: vim file, use position
alias ve=". /bin/gisanfu-pos-editfile.sh 1"
alias vee=". /bin/gisanfu-pos-editfile.sh 2"
alias veee=". /bin/gisanfu-pos-editfile.sh 3"
alias veeee=". /bin/gisanfu-pos-editfile.sh 4"
alias veeeee=". /bin/gisanfu-pos-editfile.sh 5"
alias veeeeee=". /bin/gisanfu-pos-editfile.sh 6"
